PrintStatus: PrtStatPaper, PrtStatToner, PrtStatMem, PrtStatOff
PrintingSpeed: DeskPrntSpd
PaperOrientation: PgOrnttnOK
PrintingArea: PrntngArOK
NonTrueTypeFonts: NnPSGrphc, NnTTOK
GraphicsSettings: GrphcsRltdDrvrSttngs
TrueTypeFonts: TrTypFnts, TTOK
Problem: Problem1, Problem2, Problem3, Problem4, Problem5, Problem6
LocalPrinter: LclOK, LclGrbld, DS_LCLOK
NetworkPrinter: NetPrint, NtwrkCnfg, NetOK, DS_NTOK, NtGrbld, NtSpd
NetworkConnection: NtwrkCnfg, NetOK, NetPrint, DSApplctn, PC2PRT
PrinterFile: PrtFile
PrinterDriver: PrtDriver, PrtThread, DrvOK, DrvSet
PrinterStatus: PrtStatMem, PrtStatOff, PrtStatPaper, PrtStatToner
PrinterMemory: PrtMem, PSERRMEM, AvlblVrtlMmry
PrinterPath: PrtPath, PrtMpTPth, GrbldOtpt
PrinterSpooler: PrtSpool, PrtSel, PrtQueue
PrinterPort: PrtPort, PrtCbl, CblPrtHrdwrOK
PrintTimeout: PrtTimeOut
FontInstallation: FntInstlltn
FontSettings: ScrnFntNtPrntrFnt
GraphicsRelated: EPSGrphc, PSGRAPHIC, PrtPScript
PrintCompletion: CmpltPgPrntd
TonerSupply: TnrSpply
PrintError: FllCrrptdBffr, IncmpltPS, GrbldPS
PrintProcess: PrntPrcssTm
ApplicationData: AppDtGnTm, AppData
ApplicationStatus: AppOK, EMFOK
DataFile: DataFile
DiskLocal: DskLocal
PrinterOffline: PTROFFLINE